************************************************************
************************************************************
**------T--------------------------------------T----------**
**--------------------------------------------------------**
**-----******----------------T--------------*******-------**
**-----****---------------------------------**---**-------**
**-----------T-----------*********----------**---**-------**
**-----------------------*********------------------------**
**------****----------------***---------------------------**
**------****------------T---***---T-----------------------**
**--------------------------***----------------------T----**
**--------------------------***---------------------------**
**--------------T------------------------T----------------**
**---------------------------T----------------------------**
**--------------------------------------------------------**
**---------**-------------------------------**------------**
**---------**-------------------------------**------------**
**---------**-------------------------------**------------**
**----T----**----------------S--------------**-------T----**
**---------**-------------------------------**------------**
**---------**-------------------------------**------------**
**---------**-------------------------------**------------**
**---------**-------------------------------**------------**
**---------********-------------------********------------**
**---------********--------******-----********------------**
**-------------------------******-------------------------**
**--------------------------------------------------------**
**---------------T------------T----------T----------------**
**--------------------------------------------------------**
**--------------------------------------------------------**
**--------------------------------------------------------**
**--------T-----------------------------------------------**
**-------------------------******-------------------------**
**------------------------------------------**------------**
**-------****-------------------------------**-----T------**
**---------**-----------------T-------------**------------**
**------T-------------------------------------------------**
**--------------------------------------------------------**
************************************************************
************************************************************