************************************************************
************************************************************
**--------------------------------------------------------**
**---S--TTTTTTTTTTTTTTTTTTTTTTTTTTTTTTTTTTTTTTTTTTTTTT----**
**---------------------------------------------------T----**
************************************************-----T----**
**---------------------------------------------------T----**
**---TTTTTTTTTTTTTTTTTTTTTTTTTTTTTTTTTTTTTTTTTTTTTTTTT----**
**---T----------------------------------------------------**
**---T----**************************************************
**---T----------------------------------------------------**
**---TTTTTTTTTTTTTTTTTTTTTTTTTTTTTTTTTTTTTTTTTTTTTTTTT----**
**---------------------------------------------------T----**
************************************************-----T----**
**---------------------------------------------------T----**
**---TTTTTTTTTTTTTTTTTTTTTTTTTTTTTTTTTTTTTTTTTTTTTTTTT----**
**---T----------------------------------------------------**
**---T----**************************************************
**---T----------------------------------------------------**
**---TTTTTTTTTTTTTTTTTTTTTTTTTTTTTTTTTTTTTTTTTTTTTTTTT----**
**---------------------------------------------------T----**
************************************************-----T----**
**---------------------------------------------------T----**
**---TTTTTTTTTTTTTTTTTTTTTTTTTTTTTTTTTTTTTTTTTTTTTTTTT----**
**---T----------------------------------------------------**
**---T----**************************************************
**---T----------------------------------------------------**
**---TTTTTTTTTTTTTTTTTTTTTTTTTTTTTTTTTTTTTTTTTTTTTTTTT----**
**---------------------------------------------------T----**
************************************************-----T----**
**---------------------------------------------------T----**
**---TTTTTTTTTTTTTTTTTTTTTTTTTTTTTTTTTTTTTTTTTTTTTTTTT----**
**---T----------------------------------------------------**
**---T----**************************************************
**---T----------------------------------------------------**
**---TTTTTTTTTTTTTTTTTTTTTTTTTTTTTTTTTTTTTTTTTTTTTTTTE----**
**--------------------------------------------------------**
************************************************************
************************************************************