************************************************************
************************************************************
**--------------------------------------------------------**
**--------------------------------------------------------**
**--------------------------------------------------------**
**------------------------------------------*********-----**
**-----*****-------------*********----------*-------*-----**
**---------------------------*--------------*-------*-----**
**---------------------------*--------------*-------*-----**
**---------------------------*----------------------------**
**---------------------------*----------------------------**
**---------------------------*----------------------------**
**----------E---------------------------------------------**
**--------------T-----------------------------------------**
**--------------------------------------------------------**
**--------------------------------------------------------**
**---------*---------T-----------------------*------------**
**---------*---------------------------------*------------**
**---------*-----------------S---------------*------------**
**---------*---------------------------------*------------**
**---------*---------------------------------*------------**
**---------*---------------------------------*------------**
**---------*---------------------------------*------------**
**---------*---------------------------------*------------**
**---------********-------------------********------------**
**--------------------------****--------------------------**
**--------------------------------------------------------**
**--------------------------------------------------------**
**--------------------------------------------------------**
**--------------------------------------------------------**
**--------------------------------------------------------**
**-------------------------******-------------------------**
**---------*---------------*----*-----------*-------------**
**---------*--------------------------------*-------------**
****----------------------------------------*-------------**
**--------------------------------------------------------**
**--------------------------------------------------------**
**--------------------------------------------------------**
************************************************************
************************************************************